...###..$....###........#
..##.#.####...#..#...#..#
.##..###..#.....######.##
##........#..#..........#
#...@..#..#...#...###.##.
###..###.......#.##..*...
..#..#....#..##.....#...#
.##.##.#.##.....#####...#
.#.....###...####....##..
.#.....##....#..#.###....
#...##.....##..#...#.....
*..######........##....#.
##.........#####....&....