.####.....#....##.......
#...#..####.#.#...######
#........#..#..#.....###
.#...........*.##.##.##.
##...@...#.#...##.#..###
......#...####..#...##.#
....#...####...###...#..
#...#.....##.#.....#..##
#..####.#....###...#....
#..##.##..#..###.##.####
####...#.##..###....#..&
$....#....##.....##...#.
##......####....#.###.##